[
  {
    "chunk": 1,
    "ids": [
      1,2,3,4,5,6,7,8,9,10,
      1,2,3,4,5,6,7,8,9,10,
      1,2,3,4,5,6,7,8,9,10,
      1,2,3,4,5,6,7,8,9,10,
      1,2,3,4,5,6,7,8,9,10,
      1,2,3,4,5,6,7,8,9,10,
      1,2,3,4,5,6,7,8,9,10,
      1,2,3,4,5,6,7,8,9,10,
      1,2,3,4,5,6,7,8,9,10,
      1,2,3,4,5,6,7,8,9,10
    ]
  },  {
  "chunk": 2,
  "ids": [
    1,2,3,4,5,6,7,8,9,10,
    1,2,3,4,5,6,7,8,9,10,
    1,2,3,4,5,6,7,8,9,10,
    1,2,3,4,5,6,7,8,9,10,
    1,2,3,4,5,6,7,8,9,10,
    1,2,3,4,5,6,7,8,9,10,
    1,2,3,4,5,6,7,8,9,10,
    1,2,3,4,5,6,7,8,9,10,
    1,2,3,4,5,6,7,8,9,10,
    1,2,3,4,5,6,7,8,9,10
  ]
}
]